1 1 1 1 1 1 1 1 1 1 1 1 1 1 1 1 1 1 1 1 1 1 1 1
1 2 6 2 2 6 2 2 6 2 6 2 2 6 2 6 2 2 6 2 2 6 2 1
1 2 0 2 2 0 0 0 0 0 0 0 0 0 0 0 0 0 0 0 0 0 0 1
1 4 0 4 4 0 1 1 1 0 1 1 1 1 1 1 1 1 1 1 0 1 1 1
1 0 0 4 4 0 1 1 1 0 1 1 1 1 1 1 1 1 1 1 0 2 2 1
1 1 0 4 4 0 5 5 5 0 2 2 2 2 3 3 3 3 4 4 0 2 2 1
1 1 0 4 4 0 5 5 5 0 2 2 2 2 3 7 7 3 4 4 0 2 2 1
1 1 0 0 0 0 0 0 0 0 3 3 3 3 3 3 3 3 3 3 0 2 2 1
1 1 5 5 0 3 3 3 3 0 4 4 0 0 0 0 0 0 0 0 0 2 2 1
1 1 5 5 0 2 2 2 1 1 4 4 0 4 4 3 5 5 5 5 5 1 1 1
1 1 5 5 0 3 7 2 2 2 4 4 0 4 3 3 5 5 5 4 4 1 1 1
1 1 1 1 0 3 7 2 1 1 0 0 0 0 0 5 5 5 5 0 0 0 0 1
1 1 1 1 0 2 2 2 1 1 0 5 5 5 0 2 2 2 5 0 5 3 2 1
1 5 5 0 0 0 0 0 0 0 0 5 5 5 0 2 7 2 5 0 5 2 2 1
1 7 5 0 1 1 1 1 1 1 1 1 1 1 0 2 2 2 4 0 5 2 3 1
1 5 5 0 0 0 0 0 3 3 3 0 0 0 0 2 2 2 5 0 5 3 2 1
1 5 5 0 1 1 1 1 1 1 1 1 1 1 0 2 2 2 5 0 5 7 7 1
1 5 5 0 2 2 2 2 2 2 2 2 2 2 0 2 2 2 5 0 5 1 1 1
1 5 5 0 0 0 0 0 0 1 1 1 1 1 0 5 5 5 5 0 5 1 1 1
1 1 1 0 3 5 5 4 4 0 2 2 2 2 0 2 2 2 2 0 0 0 1 1
1 1 1 0 3 5 5 4 4 0 0 0 0 0 0 2 2 2 2 2 2 0 1 1
1 0 0 0 3 5 5 4 4 0 2 0 2 2 0 0 0 0 0 0 0 0 0 1
1 7 7 0 3 5 5 4 4 0 2 8 2 2 0 4 4 3 4 0 3 2 2 1
1 1 1 1 1 1 1 1 1 1 1 1 1 1 1 1 1 1 1 1 1 1 1 1